D:1;S:0
++++++++++
+###@    +
+        +
+        +
+        +
+        +
+        +
+        +
+       F+
++++++++++