D:1;S:1
++++++++++
+        +
+        +
+ ###@   +
+        +
+        +
+        +
+     F  +
+        +
++++++++++