D:3;S:1
++++++++++
+        +
+        +
+ @###   +
+        +
+        +
+        +
+     F  +
+        +
++++++++++